"a" = (/turf/wall,/area)
"b" = (/turf,/area)
"c" = (/turf/wall/ramp_3,/area)
"d" = (/turf/ladder,/area)
"e" = (/turf,/turf/funnel/left,/area)
"f" = (/turf,/turf/funnel/up,/turf/funnel/right,/area)
"g" = (/turf,/turf/funnel/up,/area)
"h" = (/mob/mechanism/pushable/box,/turf,/area)
"i" = (/mob/platform,/turf,/area)
"j" = (/mob/mechanism/pushable/ball/spikeball,/turf,/area)
"k" = (/mob/mechanism/spring/spring_pretty,/turf,/area)
"l" = (/mob/mechanism/linkable/door,/turf,/area)
"m" = (/mob/mechanism/linkable/button,/turf,/area)
"n" = (/mob/mechanism/linkable/door/locked,/turf,/area)
"o" = (/mob/mechanism/spring,/turf,/area)

(1,1,1) = {"
aaaaaaaaaaaaaaaaaaaaaaaaaaaaaaaaaaaaaaaaaaaaaaaaaa
abbbbbbbbbbbbbbbbbbbbbbbbbbbbbbbbbbbbbbbbbbbbbbbba
abbbbbbbbbbbbbbbbbbbbbbbbbbbbbbbbbbbbbbbbbbbbbbbba
abbbbbbbbbbbbbbbbbbbbbbbbbbbbbbbbbbbbbbbbbbcaaabba
abbbbbbbbbbbbbbbbbbbbbbbbbbbbbbbbbbbbbbbbbcabbbbba
abbbbbbbbbbbbbbbbbbbbbbbbbbbbbbbbbbbbbbbbcabbbbbba
abbbbbbbbbbbbbbbbbbbbbbbbbbbbbbbbbbbbbbbbabbbbbbba
abbbbbbbbbbbbbbbbbbbbbbbbbbbbbaaaaaaabbbbbbbbbbbba
abbbbbbbbbbbbaaaaaaaaaabbbbbbbbbbbbbbbbbbbbbbbbbba
abbbbbbbbbbbbbbbbbbbbbbbbbbbbbbbbbbbbbbbbbbbbbbbba
abbbbbbbbbbbbbbbbbbbbbbbbbbbbbbbbbbbbbbbbbbbbbbbba
abdaaaaaaaabbbbbbbbbbbbbbbbbbbbbbbbbbbbbbbbbbbbbba
abdbbbabbbabbbbbbbbbbbbbbbbbbbbbbbbbbbbbbbbbbbbbba
abdbbbabbbabbbbbbbbbbbbbbbbbbbbbbbbbbbbbbbbbbbbbba
abdbbbabbbabbbbbbbbbbbbbbbbbbbbbbbbbbbbbbbbbbbbbba
abdbbbaaaaabbbbbbbbbbbaaaaaaaaaaaaaaaaaaaaaabbbbba
abdbbbbbbbbbbbbbbbbbbbbbbbbbbbbbbbbbbbbbbbbbbbbbba
abdbbbbbbbbbbbbbbbbbbbbbbbbbbbbbbbbbbbbbbbbbbbbbba
abdbbbbbbbbbbbbbbbbbbbbbbbbbbbbbbbbbbbbbbbbbbbbbba
abdbbbbbbbbbbbbbbabbbbbbbbbbbbbbbbbbbbbbbbbbbbbbba
abdbbbbbbbbbbbbbbbbbbbbbbbbbbaaaaaaaaaaaabbbbbbbba
abdbbbbbbbbbbbbbbbbbbbbbbbbbbabbbbbbbbbbabbbbbbbba
abaaabbbbbbbbbbbbbbbbbbbbbbbbabbbbbbbbbbabbbbbbbba
abbbbbbbbbbbbbbbbbbbbbbbbbbbbabbbbbbbbbbabbbbbbbba
abbbaaabbbbbbbbbbaabbbbbbbbbbabbbbbbbbbbabbbbbbbba
abbbbbbbbbbbbbbbbbbbbbbbbbbbbabbbbbbbbbbabbbbbbbba
abbbbbbbbbbbbbbbbbbbbbbbbbbbbabbbbbbbbbbabbbbbbbba
abaaaabbbbbbbbbbbbbbbbbbbbbbbabbbbbbbbbbabbbbbbbba
abbbbbbbbbbbbbbbbbbbbbbbbbbbbabbbbbbbbbbabbbbbbbba
abbbbbbbbbbbbbbbbbbbbbbbbbbbbaaaaaaaaaaaabbbbbbbba
abbbbbbbbbbbbbaabbbbbbbbbbbbbbbbbbbbbbbbbbbbbbbbba
abbbbbbbbbbbbbbbbbbbbbbbbbbbbbbbbbbbbbbbbbbbbbbbba
abbbbbbbbbbbbbaaaaaabbaabbbbbbbbbbbbbbbbbbbbbbbbba
abbbbbbbbbbbbbabbbbabbbbbbbbbbbbbbbbbbbbbbbbbbbbba
abbbbbbbbbbbbbabbbbabbbbbbbbbbbbbbbbbbbbbbbbbbbbba
abbbbbbbbbbbbbabbbbabbbbbbbbbbbbbbbbbbbbbbbbbbbbba
abbbbbbbbbbbbbabbbbabbbbbbbbbbbbbbbbbbbbbbbbbbbbba
abbbbbbbbbbbbbaaaaaabbbbbbbbbbbbbbbbbbbbbbbbbbbbba
abeeeeeebbbbbbbbbbbbbbbbbbaaaaaaaaaaaaabbbbbbbbbba
aaaaaaaaadfbbbbbbbbbbbbbbbbbbbbbbbbbbbbbbbbbbbbbba
abbbbbbbbdfbbbbbbbbbbbbbbbbbbbbbbbbbbbbbbbbbbbbbba
abbbbbbbbdgbbbbbbbbbbbbbbbbbbbbbbbbbbbbbbbbbbbbbba
abbbbbbbbdgbbbbbbbbbbbbbbbbbbbbbbbbbbbbbbbbbbbbbba
abbbbbbbbdgbbbbbbhbbhbbbbbbbbbbbbbbbbbbbbbbbbbbbba
abbbbbbbbdgbbaaaaaaaaaibbbbbbbbbbbbbbbbbbbbbbbbbba
abbbbbbjbdgbbbbbbbbbbbbbbbbbbbbbbaaaaabbbbbbbbbbba
abbjbbhjbdgbbbbbbbbbbbbbbbbbbbbbbabbbabbbbbbbbbbba
abbbkbbbbdbbbbbbbbbbbbbbkkkkbbbbblbbmnbbbbbbbbbbba
abaaoaaaaaaaaaaaaaaaaaaaooooaaaaaaaaaaaaaaaaaaaaaa
aaaaaaaaaaaaaaaaaaaaaaaaaaaaaaaaaaaaaaaaaaaaaaaaaa
"}
